................................................................................
................................................................................
................................................................................
................................................................................
.................................#............#.................................
.................................##############.................................
................................................................................
................................................................................
.............................#...#..............................................
.............................#...#..............................................
.............................#...#..............................................
.............................#...#..............................................
.......................#######...######.........................................
.......................#..............#.........................................
.......................#..............#.........................................
.......................#..............#.........................................
.......................#..............#.........................................
.......................#..............#.........................................
.......................################.........................................
................................................................................
................................................................................
....................................######......................................
................................................................................
................................................................................
.................................######.######..................................
................................................................................
................................................................................
..............................######.######.######..............................
................................................................................
................................................................................
...........................######.######.######.######..........................
................................................................................
................................................................................
...............................#####............................................
................................................................................
................................................................................
............................#####.#####.........................................
................................................................................
................................................................................
.........................#####.#####.#####......................................
................................................................................
................................................................................
......................#####.#####.#####.#####...................................
................................................................................
................................................................................
................................................................................
................................................................................
.................#.....#.#......................................................
.................#.#...#.#......................................................
.................#.#.#.#.#......................................................
...............#.#.#.#.#.#......................................................
...............#.#.#.#.#.#......................................................
...............#.#.#.#.#.#......................................................
...............#.#.#.#.#.#......................................................
...............#.#.#.#.#.#......................................................
...............###########......................................................
................................................................................
................................................................................
................................................................................
................................................................................
........#.......................................................................
........#.......................................................................
........#.....#.................................................................
....#...#...#.#.#...............................................................
....#.#.#...#.#.#.....#.........................................................
....#.#.#.#.#.#.#.#...#.........................................................
....#.#.#.#.#.#.#.#.#.#.........................................................
....#.#.#.#.#.#.#.#.#.#.........................................................
....###################.........................................................
................................................................................
................................................................................
....................#...#.......................................................
....................#...#.......................................................
.................####...######..................................................
.................#...........#..................................................
.................#...........#..................................................
.................#...........#..................................................
.................#...........#..................................................
.................#...........#..................................................
.................#...........#..................................................
.................#...........#..................................................
.................#############..................................................
................................................................................
................................................................................
...................................#............................................
.....................###############............................................
................................................................................
................................................................................
...................................#............................................
...........................#.......#............................................
...........................#.......#............................................
...........................#.......#............................................
...........................#.#.....#.......#....................................
...........................#.#.#...#...#...#....................................
...........................#.#.#...#.#.#.#.#....................................
...........................#.#.#...#.#.#.#.#....................................
...........................#.#.#...#.#.#.#.#....................................
...........................#.#.#.#.#.#.#.#.#....................................
...........................#################....................................
................................................................................
................................................................................
..........................................#####.................................
................................................................................
................................................................................
.......................................#####.#####..............................
................................................................................
................................................................................
....................................#####.#####.#####...........................
................................................................................
................................................................................
.................................#####.#####.#####.#####........................
................................................................................
................................................................................
..............................#####.#####.#####.#####.#####.....................
................................................................................
................................................................................
...........................#..#.................................................
...........................#..#.................................................
........................####..######............................................
........................#..........#............................................
........................#..........#............................................
........................############............................................
................................................................................
................................................................................
................................................................................
..........................#.....................................................
..........................###############.......................................
................................................................................
................................................................................
....................................#...........................................
....................................#...........................................
....................................#...........................................
....................................#.......#...................................
....................................#.......#...................................
....................................#...#...#...................................
....................................#...#...#...................................
....................................#...#.#.#...................................
....................................#...#.#.#...................................
....................................#.#.#.#.#...................................
....................................#########...................................
................................................................................
................................................................................
..........................................#...#.................................
..........................................#...#.................................
..........................................#...#.................................
..........................................#...#.................................
........................................###...#######...........................
........................................#...........#...........................
........................................#...........#...........................
........................................#...........#...........................
........................................#...........#...........................
........................................#...........#...........................
........................................#...........#...........................
........................................#...........#...........................
........................................#############...........................
................................................................................
................................................................................
...................................................#####........................
................................................................................
................................................#####.#####.....................
................................................................................
.............................................#####.#####.#####..................
................................................................................
..........................................#####.#####.#####.#####...............
................................................................................
.......................................#####.#####.#####.#####.#####............
................................................................................
................................................................................
................................................................................
.............................................................#.............#....
.............................................................###############....
................................................................................
................................................................................